555555555555555555500000000555555555555555555000000005555555555555555500000000
555555555555555555500000000555555555555555555000000005555555555555555500000000
551551555555555555500000005555555555555555550000000055555555555555555500000000
545555553333333333350000005555555555555555550000000055555555555555555500000000
444515553555555555355000005555555555555555550000000055555555555555555500000000
451551153533333335355500005555555555555555550000000055555555555555555500000000
445454453535555535355555005555555555555555550000000055555555555555555500000000
444414243535333535355555555555555555555555550000000055555555555555555500000000
445422443535553535355555555555555555555555550000000055555555555555555500000000
415422253533333535355555555555555555555555550000000055555555555555555500000000
554422253555555535355555555555555555555555550000000055555555555555555500000000
555425453333333334355555555555555555555555550000000055555555555555555500000000
155425544545554545455555555555555555555555550000000055555555555555555500000000
444414554444444544415555155555555555555555550000000055555555555555555500000000
445445445454444444555555555555555555555555550000000055555555555555555500000000
444444444444424444444555555555555555555555550000000055555555555555555500000000
555555555555555555500000000555555555555555555000000005555555555555555500000000
551551555555555555500000005555555555555555550000000055555555555555555500000000
545555553333333333350000005555555555555555550000000055555555555555555500000000
444515553555555555355000005555555555555555550000000055555555555555555500000000
451551153533333335355500005555555555555555550000000055555555555555555500000000
445454453535555535355555005555555555555555550000000055555555555555555500000000
444414243535333535355555555555555555555555550000000055555555555555555500000000
445422443535553535355555555555555555555555550000000055555555555555555500000000
415422253533333535355555555555555555555555550000000055555555555555555500000000
554422253555555535355555555555555555555555550000000055555555555555555500000000
555425453333333334355555555555555555555555550000000055555555555555555500000000
155425544545554545455555555555555555555555550000000055555555555555555500000000
444414554444444544415555155555555555555555550000000055555555555555555500000000
445445445454444444555555555555555555555555550000000055555555555555555500000000
444444444444424444444555555555555555555555550000000055555555555555555500000000
551551555555555555500000005555555555555555550000000055555555555555555500000000
545555553333333333350000005555555555555555550000000055555555555555555500000000
444515553555555555355000005555555555555555550000000055555555555555555500000000
451551153533333335355500005555555555555555550000000055555555555555555500000000
445454453535555535355555005555555555555555550000000055555555555555555500000000
444414243535333535355555555555555555555555550000000055555555555555555500000000
445422443535553535355555555555555555555555550000000055555555555555555500000000
415422253533333535355555555555555555555555550000000055555555555555555500000000
554422253555555535355555555555555555555555550000000055555555555555555500000000
555425453333333334355555555555555555555555550000000055555555555555555500000000
155425544545554545455555555555555555555555550000000055555555555555555500000000
444414554444444544415555155555555555555555550000000055555555555555555500000000
445445445454444444555555555555555555555555550000000055555555555555555500000000
444444444444424444444555555555555555555555550000000055555555555555555500000000